1111111111111111111111111111111111
100000000000000C00000C000000000101
1E1C001100100000101001000000010001
1101110010101010001001111111010101
1P0000000C00C0001000000000000000C1
1111111111111111111111111111111111
