111111111111111111111111111111111111111111111111111111111111111
10000100010000C00010C00001000000C00001C10000000100001000CCC00E1
1P10000C000000001000010000000010000000000001C1000010001011C1001
111111111111111111111111111111111111111111111111111111111111111